axios,3,3.1,6,9,True
node-fs-extra,0,3,2,5,True
Inquirer.js,0,0,107,107,True
express,0,31,66,97,True
ts-node,0,12,3,15,True
qs,0,1,9,10,True
readable-stream,0,4,3,7,True
resolve,0,3,2,5,True
http-proxy-middleware,0,6,11,17,True
node-deep-equal,0,17,74,91,True
meow,0,12,60,72,True
eslint-plugin-node,0,7,162,169,True
got,0,11,13,24,True
jsdom,0,26,1,27,True
ava,0,45,136,181,True
svgo,0,6,18,24,True
execa,0,9,7,16,True
compression,0,7,5,12,True
ioredis,0,9,2,11,True
morgan,0,5,3,8,True
node-util,0,5,23,28,True
node-notifier,0,6,4,10,True
globby,0,5,19,24,True
finalhandler,0,7,2,9,True
np,0,39,455,494,True
session,0,8,2,10,True
eslint-config-standard-react,0,0,124,124,True
engine.io,0,10,9,19,True
find-cache-dir,0,2,6,8,True
mysql,0,4,8,12,True
node-gyp,0,10,130,140,True
file-type,0,3,9,12,True
xo,0,36,702,738,True
pm2,0,29,217,246,True
gulp-mocha,0,6,126,132,True
fastify,0,15,55,70,True
gulp-autoprefixer,0,6,38,44,True
shelljs,1,4,37,41,True
node-archiver,0,7,64,71,True
eslint-plugin-unicorn,0,16,174,190,True
pg-promise,0,4,16,20,True
gulp-imagemin,0,7,424,431,True
imagemin,0,7,37,44,True
cookie-session,0,4,4,8,True
jest-junit,0,4,1,5,True
serve-index,0,7,9,16,True
multiparty,0,3,6,9,True
ow,0,5,1,6,True
bitcoinjs-lib,0,8,28,36,True
leveldown,0,3,9,12,True
cloudinary_npm,0,4,88,92,True
couchdb-nano,0,6,30,36,True
nodejs-firestore,0,4,185,189,True
errorhandler,0,2,3,5,True
send,0,13,7,20,True
sharp,0,8,52,60,True
pino,0,11,11,22,True
nightwatch,0,33,360,393,True
eslint-formatter-pretty,0,8,17,25,True
docsify-cli,0,17,252,269,True
node-mssql,0,6,265,271,True
serve-favicon,0,5,0,5,True
eslint-config-standard-with-typescript,0,2,350,352,True
signale,0,3,21,24,True
engine.io-client,0,5,4,9,True
cson,0,4,5,9,True
global-modules,0,1,4,5,True
decompress,0,8,48,56,True
to-regex,0,4,14,18,True
dockerode,0,3,35,38,True
gray-matter,0,4,6,10,True
gulp-changed,0,5,22,27,True
pkg,0,14,153,167,True
amqplib,0,4,10,14,True
cacheable-request,0,7,2,9,True
elasticsearch-js,0,2,9,11,True
node-rest-client,0,3,3,6,True
method-override,0,4,1,5,True
firebase-admin-node,0,8,290,298,True
hapi,0,18,62,80,True
eslint-plugin-ava,0,8,124,132,True
download,0,11,119,130,True
base,0,5,43,48,True
memdown,0,5,9,14,True
terminal-link,0,2,4,6,True
cli-progress,0,1,4,5,True
snazzy,0,7,15,22,True
simple-get,0,3,2,5,True
gulp-strip-debug,0,4,98,102,True
tedious,0,12,233,245,True
yo,0,31,1007,1038,True
nanomatch,0,11,61,72,True
Caporal.js,0,13,131,144,True
email-templates,0,8,272,280,True
markdown-toc,0,12,57,69,True
nodegit,0,9,235,244,True
swagger,0,5,17,22,True
cordova-android,0,11,89,100,True
extglob,0,8,64,72,True
expand-brackets,0,4,66,70,True
gulp-filter,0,4,29,33,True
sitemap.js,0,4,1,5,True
grunt-eslint,0,2,122,124,True
gulp-zip,0,5,34,39,True
define-property,0,2,5,7,True
clone-deep,0,3,2,5,True
cache-base,0,8,28,36,True
electron-prebuilt,0,3,140,143,True
eslint-config-xo-space,0,1,125,126,True
level,0,2,21,23,True
lite-server,0,5,314,319,True
cordova-node-xcode,0,2,7,9,True
gulp-size,0,8,27,35,True
gulp-ruby-sass,0,15,62,77,True
snapdragon,0,11,35,46,True
node-core-test,0,2,75,77,True
cli-table3,0,1,5,6,True
levelup,0,6,17,23,True
node-mocks-http,0,10,0,10,True
oclif,0,18,911,929,True
hexo,0,24,153,177,True
cat-names,0,2,67,69,True
alfy,0,12,326,338,True
schematics,0,5,77,82,True
moleculer,0,10,28,38,True
cordova-cli,0,13,726,739,True
airtap,0,31,825,856,True
gulp-debug,0,6,25,31,True
nodejs-sdk,0,11,143,154,True
agenda,0,6,24,30,True
express-status-monitor,0,6,40,46,True
primus,0,10,28,38,True
imagemin-gifsicle,0,3,275,278,True
into-stream,0,2,10,12,True
gulp-template,0,3,16,19,True
couchnode,0,4,172,176,True
handlebars-helpers,0,28,355,383,True
ms-rest-js,0,9,18,27,True
jwt,0,2,13,15,True
nest-cli,0,22,391,413,True
node-crawler,0,7,100,107,True
cordova-ios,0,11,101,112,True
standard-engine,0,4,15,19,True
is-online,0,4,37,41,True
nodejs-vision,0,3,185,188,True
gaxios,0,4,8,12,True
node-fast-html-parser,0,2,13,15,True
router,0,7,1,8,True
art-template,0,8,29,37,True
nodejs-pubsub,0,16,188,204,True
javascript-obfuscator,0,23,0,23,True
env-cmd,0,2,5,7,True
gulp-gh-pages,0,7,129,136,True
webtorrent,0,44,198,242,True
mongoosastic,0,3,33,36,True
abstract-leveldown,0,6,3,9,True
farmhash,0,2,46,48,True
trash,0,8,56,64,True
expand-range,0,2,9,11,True
isomorphic-git,0,11,14,25,True
peerjs-server,0,4,123,127,True
projectz,0,9,11,20,True
string-to-stream,0,1,4,5,True
limax,0,3,15,18,True
regex-not,0,2,5,7,True
watchr,0,6,17,23,True
socketcluster,0,4,61,65,True
node-website-scraper,0,9,67,76,True
node-hid,0,3,47,50,True
codeceptjs,0,36,0,36,True
assemble,0,18,1480,1498,True
node-telegram-bot-api,0,9,204,213,True
gulp-jasmine,0,5,37,42,True
chalk-animation,0,3,75,78,True
relateurl,0,5,177,182,True
zx,0,13,48,61,True
nodejs-speech,0,6,211,217,True
simple-peer,0,7,0,7,True
parse-torrent,0,6,8,14,True
favicon,0,5,0,5,True
gluegun,0,30,0,30,True
caw,0,4,9,13,True
parse-filepath,0,3,5,8,True
ssh2-sftp-client,0,3,18,21,True
yaspeller,0,16,20,36,True
pretty,0,2,28,30,True
labeled-stream-splicer,0,2,10,12,True
cmake-js,0,13,71,84,True
babel-preset-stage-4,0,5,132,137,True
firefox-profile-js,0,5,8,13,True
npm-run,0,4,6,10,True
object.defaults,0,4,1,5,True
awilix,0,2,25,27,True
copy,0,14,106,120,True
strong-error-handler,0,7,75,82,True
nexe,0,14,255,269,True
bittorrent-dht,0,8,16,24,True
node-argon2,0,3,71,74,True
solana-web3.js,0,16,58,74,True
rxdb,0,35,403,438,True
eslint-plugin-n,0,8,135,143,True
taskgroup,0,4,7,11,True
merge-deep,0,3,15,18,True
encoding-down,0,4,10,14,True
gulp-chmod,0,3,8,11,True
grunt-filerev,0,3,7,10,True
has-symbol-support-x,0,2,12,14,True
ky-universal,0,2,8,10,True
timeout,0,4,5,9,True
create-torrent,0,11,1,12,True
purest,0,5,31,36,True
connect-session-knex,0,2,21,23,True
fancy-test,0,8,9,17,True
node-resque,0,1,11,12,True
gulp-markdown,0,4,15,19,True
rpc-websockets,0,4,7,11,True
stream-splicer,0,2,8,10,True
cordova-js,0,3,47,50,True
rewiremock,0,8,153,161,True
penthouse,0,5,50,55,True
node-google-spreadsheet,0,3,38,41,True
Shopify-api-node,0,4,46,50,True
loopback-connector-mysql,0,6,83,89,True
delete-empty,0,4,13,17,True
node-gcm,0,3,61,64,True
phantomjs-node,0,3,133,136,True
deglob,0,6,16,22,True
resolve-dir,0,2,13,15,True
renamer,0,12,42,54,True
multistream,0,2,5,7,True
mineflayer,0,17,123,140,True
arangojs,0,5,24,29,True
cordova-common,0,17,55,72,True
pm2-io-apm,0,10,0,10,True
express-mysql-session,0,4,23,27,True
nodejs-bigquery,0,12,76,88,True
gradient-string,0,2,7,9,True
node-jira-client,0,2,65,67,True
swagger-cli,0,4,51,55,True
webdav-client,0,13,13,26,True
gpu.js,0,5,0,5,True
loopback-connector-mongodb,0,6,97,103,True
docker-modem,0,4,13,17,True
hygen,0,14,115,129,True
aedes,0,12,33,45,True
apostrophe,0,88,1031,1119,True
global-agent,0,8,28,36,True
gulp-nunjucks,0,4,37,41,True
inversify-express-utils,0,3,87,90,True
node-xmpp,0,0,411,411,True
claudia,0,13,150,163,True
babel-preset-transform-test-files,0,2,53,55,True
broken-link-checker,0,33,285,318,True
csv-stream,0,1,10,11,True
xtemplate,0,0,5,5,True
strong-soap,0,12,135,147,True
symlink-dir,0,2,22,24,True
nodejs-error-reporting,0,2,65,67,True
junit-report-builder,0,4,1,5,True
metalsmith-layouts,0,4,5,9,True
changelog-maker,0,16,657,673,True
node-hue-api,0,4,41,45,True
apm-agent-nodejs,0,34,194,228,True
pdfjs,0,6,9,15,True
pmx,0,5,19,24,True
actionhero,0,17,126,143,True
jest-mongodb,0,2,166,168,True
node-neo4j,0,2,60,62,True
discord.io,0,3,2,5,True
cote,0,9,72,81,True
node-measured,0,0,15,15,True
appmetrics,0,6,325,331,True
cli-columns,0,2,4,6,True
is-reachable,0,8,45,53,True
browser-run,0,12,235,247,True
dugite,0,2,10,12,True
season,0,3,41,44,True
jsdoc-api,0,9,51,60,True
npm-package-json-lint,0,17,126,143,True
pg-monitor,0,1,33,34,True
apify-sdk-js,281,0,1727,1727,True
docx,0,5,0,5,True
gulp-ava,0,7,628,635,True
gulp-vulcanize,0,4,65,69,True
js-xlsx,0,7,15,22,True
express-openapi-validator,0,14,51,65,True
loopback-connector-postgresql,0,8,99,107,True
cordova-lib,0,16,515,531,True
terminal-image,0,5,391,396,True
openwhisk-client-js,0,2,6,8,True
prettier-check,0,1,15,16,True
term-img,0,2,22,24,True
youtube-node,0,3,94,97,True
node-libcurl,0,7,0,7,True
swagger-express-middleware,0,11,88,99,True
nodejs-logging-bunyan,0,2,242,244,True
nodejs-logging-winston,0,4,248,252,True
admin-bro,0,40,977,1017,True
right-align,0,1,4,5,True
threads.js,0,4,1,5,True
unzip-stream,0,2,4,6,True
node-sonos,0,4,4,8,True
packager,0,2,30,32,True
facebook-node-sdk,0,5,13,18,True
ascii-progress,0,3,4,7,True
node-ffmpeg-installer,0,0,8,8,True
mixpanel-node,0,1,5,6,True
restana,0,1,4,5,True
node-casbin,0,4,1,5,True
broccoli-clean-css,0,3,92,95,True
generator-license,0,1,525,526,True
gulp-html-replace,0,6,14,20,True
koa-websocket,0,4,3,7,True
ndb,0,10,160,170,True
subleveldown,0,6,29,35,True
node-jwk-to-pem,0,3,16,19,True
nodejs-datastore,0,8,191,199,True
node-sparkpost,0,2,55,57,True
slonik,0,20,0,20,True
HummusJS,0,1,83,84,True
line-bot-sdk-nodejs,0,6,61,67,True
shellcheck,0,4,102,106,True
tty-table,0,7,105,112,True
pal-nodejs,0,2,77,79,True
winston-logzio,0,8,46,54,True
simplifyify,0,13,882,895,True
sloc,0,4,213,217,True
textract,0,14,150,164,True
eslint-plugin-xo,0,16,174,190,True
axios,3,3,6,9,True
ink-link,0,2,10,12,True
opentok-node,0,4,75,79,True
maildev,0,15,215,230,True
piscina,0,3,6,9,True
cordova-serve,0,5,114,119,True
q-i,0,3,6,9,True
next-update,0,23,359,382,True
ntl,0,5,156,161,True
to-ico,0,5,111,116,True
nlm,0,8,153,161,True
deferred-leveldown,0,2,9,11,True
MathJax-node,0,4,127,131,True
find-pkg,0,1,14,15,True
verb-generate-readme,0,30,1047,1077,True
prebuildify,0,7,27,34,True
manifesto,0,4,2,6,True
nativefier,0,12,318,330,True
node-whois,0,3,32,35,True
i18next-http-backend,0,1,5,6,True
aerospike-client-nodejs,0,5,162,167,True
unimported,0,15,261,276,True
aliyun-sdk-js,0,5,19,24,True
mailjet-apiv3-nodejs,0,3,8,11,True
mediasoup-client,0,10,6,16,True
functions-framework-nodejs,0,8,238,246,True
cordova-fetch,0,8,326,334,True
ms-rest-azure-js,0,3,27,30,True
node-sdk,0,7,9,16,True
node-clinic,0,20,1062,1082,True
proxy-lists,0,7,159,166,True
node-7z,0,8,1,9,True
mem,0,2,35,37,True
kubernetes-client,0,13,160,173,True
rsmq,0,2,5,7,True
Approvals.NodeJS,0,17,729,746,True
git-parse,0,2,131,133,True
syncpack,0,10,41,51,True
etcd3,0,4,92,96,True
mediasoup,0,4,2,6,True
colyseus,3,0,411,411,True
tencentcloud-sdk-nodejs,0,6,13,19,True
get-it,0,12,20,32,True
oembed-parser,0,1,5,6,True
dd-trace-js,0,27,29,56,True
ink-big-text,0,2,21,23,True
webpack-cdn-plugin,0,1,62,63,True
postcss-color-gray,0,2,7,9,True
Ouch,0,4,16,20,True
gulp-traceur,0,4,40,44,True
cp-cli,0,2,59,61,True
node-vault,0,5,67,72,True
numjs,0,9,186,195,True
node-regedit,0,4,7,11,True
image-js,0,25,62,87,True
node-tree-sitter,0,2,73,75,True
log-process-errors,0,4,3,7,True
lmdb-js,0,5,14,19,True
nodejs-logging,0,15,220,235,True
gcloud-node,0,4,17,21,True
async-redis,0,1,5,6,True
node-gcstats,0,2,79,81,True
gulp-hb,0,7,64,71,True
iterator-stream,0,2,4,6,True
websocket-as-promised,0,4,109,113,True
yurnalist,0,5,0,5,True
node-jq,0,6,145,151,True
razorpay-node,0,3,68,71,True
merkletreejs,0,5,104,109,True
tuyapi,0,4,6,10,True
hostile,0,5,7,12,True
node-crc32-stream,0,2,6,8,True
Node-Media-Server,0,8,90,98,True
searchkit,0,1,6,7,True
cordova-create,0,11,347,358,True
git-branch,0,1,224,225,True
hads,0,22,1541,1563,True
git-username,0,2,10,12,True
iplocation,0,3,10,13,True
mongolass,0,8,40,48,True
compress-images,0,15,851,866,True
arraybuffer-loader,0,1,4,5,True
download-cli,0,2,164,166,True
express-cassandra,0,14,220,234,True
express-vue,0,8,1701,1709,True
webpack-hot-server-middleware,0,3,2,5,True
link-preview-js,0,4,42,46,True
google-play-scraper,0,5,102,107,True
sofa-rpc-node,0,17,167,184,True
noflo-nodejs,0,15,0,15,True
metapak,0,14,27,41,True
vscode-extension-telemetry,0,4,95,99,True
strapi-generate-admin,0,2,20,22,True
counterpart,0,5,0,5,True
templates,0,33,469,502,True
we-core,0,22,0,22,True
sway,0,12,89,101,True
speed-test,0,7,138,145,True
typogr.js,0,4,13,17,True
gulp-tape,0,6,565,571,True
gulp-xo,0,5,1343,1348,True
trello,0,3,5,8,True
jsdomify,0,1,115,116,True
ts-tools,0,0,129,129,True
node-mysql-utilities,0,1,12,13,True
rocksdb,0,3,9,12,True
flightplan,0,12,0,12,True
fluid-grunt-eslint,0,2,174,176,True
elastic-builder,0,8,0,8,True
learnyounode,0,14,223,237,True
test-each,0,5,7,12,True
whistle,0,31,152,183,True
nodejs-file-downloader,0,4,7,11,True
article-parser,0,6,36,42,True
data-forge-ts,0,7,4,11,True
redrun,0,15,1249,1264,True
eureka-js-client,0,4,64,68,True
cloudcmd,0,60,1738,1798,True
node-acme-client,0,4,8,12,True
npm-publish,0,4,16,20,True
grunt-markdownlint,0,1,7,8,True
electron-reloader,0,5,28,33,True
actions-toolkit,0,9,84,93,True
standard-json,0,1,8,9,True
s3-website,0,16,88,104,True
caching-transform,0,4,13,17,True
telebot,0,1,60,61,True
node-plex-api,0,5,76,81,True
handbrake-js,0,7,78,85,True
ggit,0,21,0,21,True
aperture-node,0,6,74,80,True
alexa-app,0,5,30,35,True
gulp-bom,0,2,9,11,True
scaffdog,0,0,7,7,True
join-monster,0,6,0,6,True
svgdom,0,3,168,171,True
bittorrent-protocol,0,9,7,16,True
axios-logger,0,2,5,7,True
ut_metadata,0,4,2,6,True
impress,0,7,9,16,True
pokedex-promise-v2,0,3,6,9,True
party,0,3,64,67,True
openapi-backend,0,9,26,35,True
faux-jax,0,5,0,5,True
mercurius,0,16,82,98,True
binance,0,4,4,8,True
koop,0,0,327,327,True
serverless-bundle,0,47,2870,2917,True
active-win,0,0,175,175,True
attempt-x,0,2,9,11,True
gulp-tar,0,4,108,112,True
has-to-string-tag-x,0,2,14,16,True
express-stormpath,0,23,484,507,True
level-test,0,7,98,105,True
nohm,0,6,17,23,True
napajs,0,3,158,161,True
rails-erb-loader,0,2,3,5,True
node-ul,0,2,3,5,True
simple-websocket,0,5,8,13,True
rss-to-json,0,2,8,10,True
fast-cli,0,8,322,330,True
particle-api-js,0,5,35,40,True
registry-js,0,2,77,79,True
kitsu,0,0,12,12,True
capture-website,0,5,126,131,True
gulp-remote-src,0,5,93,98,True
npm-gui,0,2,9,11,True
listr2,0,8,0,8,True
thelounge,0,27,534,561,True
jest-dynamodb,0,6,334,340,True
Haraka,0,25,520,545,True
payload,0,109,0,109,True
lighthouse-ci,0,7,300,307,True
ink-box,0,2,47,49,True
filer,0,3,16,19,True
adaro,0,8,291,299,True
bal-util,0,10,24,34,True
raml-js-parser,0,7,39,46,True
replace-x,0,6,170,176,True
webtorrent-cli,0,17,449,466,True
fhir-kit-client,0,7,14,21,True
node-resolve,0,3,2,5,True
patchwork,0,84,1777,1861,True
matrix-appservice-bridge,0,21,333,354,True
facebook-nodejs-business-sdk,0,6,68,74,True
lightship,0,5,132,137,True
node-detective-postcss,0,3,7,10,True
body-parser,0,12,25,37,True
rosnodejs,0,9,30,39,True
html-pdf-chrome,0,3,13,16,True
atdatabases,0,14,42,56,True
Ghost-CLI,0,47,609,656,True
eth-provider,0,6,5,11,True
pg-boss,0,7,21,28,True
graphql-zeus,0,0,113,113,True
socket.io,0,6,23,29,True
ynab-sdk-js,0,1,5,6,True
buttercup-core,0,21,343,364,True
clients,3,51,366,417,True
https-localhost,0,6,0,6,True
siroc,0,23,165,188,True
Snoostorm,0,1,77,78,True
spoof,0,6,5,11,True
cc,0,3,37,40,True
cordova-osx,0,7,82,89,True
caterpillar,0,3,3,6,True
matrix,0,13,32,45,True
find-file-up,0,1,13,14,True
gh,0,27,350,377,True
git-pull-or-clone,0,2,6,8,True
git-pre-commit,0,11,372,383,True
gulp-webp,0,3,328,331,True
hapijs-status-monitor,0,2,28,30,True
ipt,0,11,98,109,True
image-min,0,7,37,44,True
dawn,9,0,5122,5122,True
atom-shell,0,3,140,143,True
exiftool-vendored.js,0,5,2,7,True
samlify,0,10,7,17,True
nodejs-dns,0,7,67,74,True
socketcluster-server,0,11,35,46,True
camunda-external-task-client-js,0,2,24,26,True
bpmn-engine,0,6,11,17,True
cosmicjs-node,0,4,6,10,True
graphql-rate-limit,0,0,5,5,True
file-icon,0,1,4,5,True
cep-promise,0,2,4,6,True
nadesiko3,0,8,25,33,True
markdownlint-cli2,0,6,38,44,True
mojo.js,0,14,25,39,True
Reports.JS,0,5,328,333,True
nodegui,0,11,160,171,True
ldapts,0,7,3,10,True
umbrella,0,1,295,296,True
spinnies,0,3,11,14,True
trace-nodejs,0,21,188,209,True
windows-build-tools,0,6,0,6,True
yaml-validator,0,3,11,14,True
startserver,0,11,80,91,True
recaptcha2,0,1,60,61,True
east,0,8,5,13,True
huejay,0,3,4,7,True
node-generate-release,0,9,60,69,True
gists,0,1,24,25,True
node-glob-gitignore,0,5,12,17,True
node-grizzly,0,6,42,48,True
gitbook-summary,0,11,178,189,True
node-gry,0,4,12,16,True
feedparser-promised,0,4,84,88,True
node-eventstore,0,8,3,11,True
volkswagen,0,3,2,5,True
nodejs-bigtable,0,16,199,215,True
tldr-node-client,0,11,730,741,True
mysql-import,0,1,14,15,True
obs-websocket-js,0,7,4,11,True
xo-init,0,5,71,76,True
wechat-jssdk,0,6,75,81,True
ut_pex,0,3,3,6,True
oicq,0,5,31,36,True
coinstac,0,1,22,23,True
swagger-stats,0,9,43,52,True
typescript-node,0,12,3,15,True
quagga2,0,6,80,86,True
adminjs,0,40,977,1017,True
gramjs,0,14,43,57,True
rax-app,0,2,36,38,True
zip-it-and-ship-it,0,31,351,382,True
multileveldown,0,9,41,50,True
delay-cli,0,1,66,67,True
openrecord,0,5,458,463,True
node-cache-manager-redis,0,3,23,26,True
akismet-js,0,1,60,61,True
solidarity,0,8,0,8,True
statsd,0,1,9,10,True
node-tenpay,0,2,142,144,True
oas3-chow-chow,0,5,0,5,True
bash-match,0,4,8,12,True
mediasource,0,3,4,7,True
grunt-php,0,1,31,32,True
node-rfc,0,3,50,53,True
comedy,0,15,22,37,True
memoryjs,0,3,230,233,True
modclean,0,11,150,161,True
madrun,0,12,1017,1029,True
memlab,0,10,339,349,True
awesome-lint,0,76,486,562,True
parser-js,0,9,21,30,True
nodejs-spanner,0,27,247,274,True
coin-hive,0,7,227,234,True
torrent-discovery,0,5,90,95,True
node-ottoman,0,4,199,203,True
pact-node,0,14,89,103,True
vtils,1,21,85,106,True
electrode-native,0,3,878,881,True
discordx,0,0,243,243,True
nestjs-i18n,0,6,20,26,True
node-sdk-core,0,21,112,133,True
webcrypto,0,5,19,24,True
appmetrics-dash,0,4,1,5,True
avrgirl-arduino,0,12,107,119,True
cwd,0,2,14,16,True
gulp-esformatter,0,3,118,121,True
gulp-myth,0,4,133,137,True
nei-toolkit,0,18,509,527,True
node-is-git-repository,0,2,25,27,True
node-jsonrpc2,0,6,6,12,True
generator-express,0,4,439,443,True
electrode-confippet,0,3,3,6,True
gofer,0,4,1,5,True
node-lintspaces,0,4,12,16,True
cli-kit,0,10,18,28,True
nve,0,12,301,313,True
nestjs-plus,0,6,245,251,True
easy-soap-request,0,1,8,9,True
unfurl,0,5,19,24,True
node-ical,0,4,11,15,True
load-ip-set,0,5,7,12,True
binary-mirror-config,0,3,49,52,True
gulp-execa,0,10,62,72,True
iron-session,0,7,128,135,True
pinus,3,0,528,528,True
dev-tasks,0,29,2488,2517,True
wire-web-packages,0,0,17,17,True
nodejs-dashboard,0,11,155,166,True
mapbox-gl-native,0,4,248,252,True
role-acl,0,5,1,6,True
QCObjects,0,1,16,17,True
simple-methodize-x,0,2,9,11,True
TNWX,0,0,114,114,True
wunderbar,0,5,214,219,True
dat-registry-client,0,2,77,79,True
azure-xplat-cli,0,82,556,638,True
demeteorizer,0,5,11,16,True
html-metadata,0,4,125,129,True
node-ipinfo,0,1,14,15,True
zosconnect-node,0,5,586,591,True
winston-logsene,0,4,117,121,True
node-hcat,0,3,5,8,True
boost,0,0,2569,2569,True
gstore-node,0,12,0,12,True
omit-deep,0,2,7,9,True
node-client,0,0,47,47,True
level-rocksdb,0,2,33,35,True
lcd,0,2,6,8,True
artTemplate,0,8,29,37,True
node-os-monitor,0,2,8,10,True
node-ble,0,1,150,151,True
oas-tools,0,8,163,171,True
cachios,0,3,8,11,True
Amplitude-Node,0,0,7,7,True
node-quickbase,0,4,13,17,True
gn-api-sdk-node,0,2,10,12,True
extra-promise,0,14,130,144,True
swagger-markdown,0,5,27,32,True
plumier,0,0,3362,3362,True
nest,0,17,202,219,True
diagnostics,0,4,10,14,True
node-csv,0,0,163,163,True
json-schema-ref-parser,0,4,1,5,True
swagger-parser,2,7,13,20,True
forge-js,0,1,376,377,True
wp-calypso,0,71,76,147,True
aws-lambda-powertools-typescript,0,1,7,8,True
azure-sdk-for-node,0,7,98,105,True
happy-dom,235,0,422,422,True
putout,0,0,1555,1555,True
markdownlint,0,1,6,7,True
discord.js,0,0,20,20,True
graphql-yoga,0,0,62,62,True
patch-package,0,14,43,57,True
egg,0,41,0,41,True
feathers,961,0,2214,2214,True
freesewing,0,12,83,95,True
nestjs,0,6,245,251,True
google-api-nodejs-client,0,2,63,65,True
nodejs-storage,0,17,63,80,True
google-maps-services-js,0,5,18,23,True
pancake,0,0,7,7,True
postgraphile,0,27,129,156,True
hemera,0,0,328,328,True
linkifyjs,0,0,25,25,True
version-bump-prompt,0,8,75,83,True
keystone,0,25,69,94,True
joplin,0,4,19,23,True
lockfile-lint,0,0,61,61,True
zora,0,0,35,35,True
lskjs,0,10,2882,2892,True
marble,0,2,102,104,True
marko,0,0,177,177,True
medusa,0,8,41,49,True
botbuilder-js,0,0,38,38,True
mikro-orm,0,0,15,15,True
mocha,0,21,69,90,True
node-mongodb-native,0,3,16,19,True
node-convict,0,0,7,7,True
envelop,0,0,52,52,True
napi-rs,0,0,70,70,True
node-rs,0,0,11,11,True
pollyjs,0,0,1242,1242,True
build,0,0,1180,1180,True
node-opcua,0,68,2560,2628,True
opentelemetry-js,1334,0,2666,2666,True
zipkin-js,0,2,24,26,True
patternlab-node,3,11,4166,4177,True
octicons,0,18,1533,1551,True
node-redis,0,6,10,16,True
reg-suit,0,0,876,876,True
rollbar.js,0,7,4,11,True
wind-layer,0,0,10,10,True
secretlint,0,0,372,372,True
connect,0,4,9,13,True
eslint-config,0,6,171,177,True
grant,0,3,42,45,True
spike,0,6,1242,1248,True
framework,1451,0,4051,4051,True
Ghost,0,0,58,58,True
SDK,0,0,620,620,True
vendure,0,0,14,14,True
monorepo,0,0,12,12,True
loaders.gl,0,0,43,43,True
webiny-js,0,0,149,149,True
node-measured,0,0,15,15,True
